###############################################################################################################################################
#@$                                                                                                                                          .#
# #############################################################################################################################################
# $                                                                                                                                          .#
# #############################################################################################################################################
# $                                                                                                                                          .#
# #############################################################################################################################################
# $                                                                                                                                          .#
# #############################################################################################################################################
# $                                                                                                                                          .#
# #############################################################################################################################################
# $                                                                                                                                          .#
# #############################################################################################################################################
# $                                                                                                                                          .#
# #############################################################################################################################################
# $                                                                                                                                          .#
# #############################################################################################################################################
# $                                                                                                                                          .#
# #############################################################################################################################################
# $                                                                                                                                          .#
# #############################################################################################################################################
# $                                                                                                                                          .#
# #############################################################################################################################################
# $                                                                                                                                          .#
############################################################################################################################################### 
